                                                                                                                                                    
              ▓▓▓▓▓▓▓▓▓▓▓▓▓▓                                                                           ▓▓                                           
          ▓▓▓▓▓▓▓▓▓▓▓▓▓▓▓▓▓▓▓▓                                                                       ▓▓▓▓▓▓▓▓                        ▓▓▓▓           
          ▓▓▓▓▓▓▓▓▓▓▓▓▓▓▓▓▓▓▓▓▓▓                                                           ▓▓▓▓▓▓▓▓▓▓▓▓▓▓▓▓▓▓                  ▓▓▓▓▓▓▓▓▓▓           
    ▓▓▓▓▓▓▓▓▓▓▓▓▓▓▓▓▓▓▓▓▓▓▓▓▓▓▓▓▓▓▓▓                                             ▓▓▓▓▓▓▓▓▓▓▓▓▓▓▓▓▓▓▓▓▓▓▓▓▓▓▓▓▓▓              ▓▓▓▓▓▓▓▓▓▓▓▓▓▓▓▓▓▓▓▓▓  
      ▓▓▓▓▓▓▓▓▓▓▓▓▓▓▓▓▓▓▓▓▓▓▓▓▓▓▓▓▓▓▓▓                                         ▓▓▓▓▓▓▓▓▓▓▓▓▓▓▓▓▓▓▓▓▓▓▓▓▓▓▓▓▓▓▓▓▓▓          ▓▓▓▓▓▓▓▓▓▓▓▓▓▓      ▓▓▓  
            ▓▓▓▓▓▓▓▓▓▓▓▓▓▓▓▓▓▓▓▓▓▓▓▓▓▓▓▓                                   ▓▓▓▓▓▓▓▓▓▓▓▓▓▓▓▓▓▓▓▓▓▓▓▓▓▓▓▓▓▓▓▓▓▓▓▓▓▓▓▓      ▓▓▓▓▓▓▓▓▓▓▓▓▓▓▓▓      ▓▓░  
  ▓▓                ▓▓▓▓▓▓▓▓▓▓▓▓▓▓▓▓▓▓▓▓▓▓                             ▓▓▓▓▓▓▓▓▓▓▓▓▓▓▓▓▓▓▓▓▓▓▓▓▓▓▓▓▓▓▓▓▓▓▓▓▓▓▓▓▓▓▓▓▓▓▓▓  ▓▓▓▓▓▓▓▓▓▓▓▓▓▓▓▓▓▓      ▓  
▓▓▓▓                  ▓▓▓▓▓▓▓▓▓▓▓▓▓▓▓▓▓▓▓▓▓▓                           ▓▓▓▓▓▓▓▓▓▓▓▓▓▓▓▓▓▓▓▓▓▓▓▓  ▓▓▓▓▓▓▓▓▓▓▓▓▓▓▓▓▓▓▓▓▓▓▓▓▓▓▓▓    ▓▓▓▓        ░░  ▓  
▓▓                    ▓▓▓▓▓▓▓▓▓▓▓▓▓▓▓▓▓▓▓▓▓▓▓▓                         ▓▓▓▓▓▓▓▓▓▓▓▓▓▓▓▓▓▓▓▓        ▓▓▓▓                          ▓▓▓▓      ▓▓░░▓▓▓  
    ░░                  ▓▓▓▓▓▓▓▓▓▓▓▓▓▓▓▓▓▓▓▓▓▓                      ▓▓▓▓▓▓▓▓▓▓▓▓▓▓▓▓▓▓▓▓▓          ▓▓    ▓▓                      ▓▓▓▓      ▓▓    ▓  
                        ▓▓▓▓▓▓▓▓▓▓▓▓▓▓▓▓▓▓▓▓▓▓                      ▓▓▓▓▓▓▓▓▓▓▓▓▓  ▓▓▓▓  ▓▓        ▓▓                            ▓▓▓▓          ░░▓▓▓
▓▓░░      ░░              ▓▓▓▓▓▓▓▓▓▓▓▓▓▓▓▓▓▓▓▓                      ▓▓▓▓▓▓▓▓▓▓▓▓▓  ▓▓              ▓▓                            ▓▓              ░▓▓
  ▓▓░░░░░░    ▓▓          ▓▓▓▓▓▓▓▓▓▓▓▓▓▓  ▓▓▓▓                      ▓▓ ▓▓▓▓▓▓▓▓                                ▓▓                ▓▓            ░░░  
▓▓▓▓▓▓  ░░    ░░            ▓▓▓▓▓▓▓▓▓▓  ▓▓▓▓▓▓                ▓▓    ▓▓ ▓▓▓▓▓▓▓▓              ▓▓                                                ░░   
▓▓▓▓▓▓  ░░░░      ▓▓▓▓      ▓▓▓▓▓▓▓▓▓▓  ▓▓▓▓▓▓                ▓▓       ▓▓▓▓▓▓              ▓▓            ▓▓                    ▓▓              ░░░  
▓▓▓▓  ░░░░░░        ░░▓▓      ▓▓▓▓▓▓      ▓▓                    ▓▓    ▓▓▓▓▓▓▓                                                                ░░░░▓  
▓▓▓▓░░░░░░░░                  ▓▓▓▓▓▓      ▓▓              ▓▓    ▓▓    ▓▓▓▓▓▓▓                                                ░░              ░░░░   
▓▓▓▓░░░░░░░░                  ▓▓▓▓▓▓      ▓▓              ▓▓    ▓▓    ▓▓▓▓▓▓▓                                                ░░  ▓▓            ░░   
▓▓░░░░                          ▓▓▓▓  ▓▓                               ▓▓▓▓▓▓                                            ░░  ░░          ░░         
▓▓░░    ░░░░▓▓▓▓                ▓▓▓▓  ▓▓          ▓▓                   ▓▓▓▓▓▓                                    ▓▓          ░░░░                   
      ░░    ░░░░                ▓▓▓▓  ▓▓          ▓▓      ▓▓      ▓▓                                                       ░░░░░░      ▓▓           
              ░░                ▓▓▓▓                      ▓▓      ▓▓▓▓                                               ▓▓    ▓▓░░▓▓░░  ▓▓             
  ░░            ▓▓              ▓▓                        ▓▓                             ░░                          ░░░░▓▓▓▓  ▓▓░░  ░░             
  ░░            ▓▓  ▓▓          ▓▓                        ▓▓                               ▓▓                      ▓▓░░▓▓▓▓    ▓▓                   
▓▓░░░░░░▓▓      ▓▓                              ▓▓                  ▓▓                     ░░▓▓          ▓▓  ░░    ░░  ▓▓▓▓        ░░               
▓▓  ░░  ░░  ░░  ▓▓                              ▓▓                                           ░░            ▓▓░░░░    ▓▓▓▓▓▓        ░░░░  ▓        ░ 
▓▓▓▓  ░░░░  ░░░░▓▓    ▓▓                                                   ▓▓▓▓              ░░          ▓▓▓▓  ░░  ▓▓▓▓          ▓▓░░░░           ░ 
▓▓▓▓▓▓▓▓  ▓▓  ░░░░    ▓▓                      ▓▓                                           ░░░░          ▓▓▓▓      ▓▓            ▓▓▓▓             ░ 
  ▓▓  ▓▓▓▓▓▓                                                                             ░░░░░░            ▓▓░░▓▓▓▓              ▓▓▓▓▓▓▓▓           
          ▓▓▓▓  ░░              ▓▓                                                     ░░░░▓▓░░              ░░▓▓▓▓              ▓▓▓▓▓▓▓▓▓▓       ░░
          ▓▓▓▓  ░░  ▓▓                                          ▓▓▓▓                 ▓▓  ▓▓▓▓  ▓▓░░▓▓  ▓▓▓▓    ▓▓▓▓                ▓▓            ▓░░
            ▓▓▓▓░░░░  ░░░░    ░░▓▓                              ▓▓                         ▓▓  ▓▓░░      ░░  ▓▓▓▓                  ▓▓               
              ▓▓░░░░  ░░░░░░░░                                                         ░░  ▓▓▓▓▓▓░░      ░░  ▓▓                    ▓▓    ░░       ▓▓
              ▓▓▓▓░░  ▓▓▓▓  ▓▓░░▓▓        ▓▓▓▓▓▓                                 ▓▓    ░░▓▓▓▓▓▓▓▓  ░░      ░░▓▓                          ▓▓         
                ▓▓░░▓▓▓▓▓▓▓▓▓▓░░      ▓▓                                       ▓▓  ▓▓    ▓▓▓▓  ▓▓        ░░░░▓▓                          ░░       ▓▓
                  ▓▓▓▓▓▓▓▓      ░░          ░░                               ▓▓    ░░░░  ▓▓▓▓      ░░    ░░  ▓▓                          ░░  ░░     
                            ▓▓▓▓░░░░  ░░░░  ░░░░                             ▓▓    ▓▓▓▓▓▓▓▓    ▓▓  ░░▓▓░░▓▓▓▓▓▓                          ▓▓░░       
                            ▓▓▓▓▓▓        ▓▓░░░░                         ▓▓  ░░░░░░▓▓▓▓        ▓▓▓▓▓▓    ▓▓                              ▓▓░░░░░░░  
                              ▓▓▓▓▓▓▓▓▓▓▓▓▓▓            ▓▓                     ░░  ▓▓              ▓▓▓▓▓▓                                ▓▓  ░░  ▓  
                              ▓▓    ▓▓▓▓  ▓▓▓▓  ░░░░░░                         ░░  ▓▓                ▓▓                                  ▓▓▓▓▓▓▓▓▓  
                                              ▓▓▓▓░░░░░░  ▓▓▓▓                 ░░  ▓▓                                                      ▓▓  ▓▓   
                                              ▓▓  ▓▓  ░░    ░░           ▓▓░░  ░░▓▓▓▓                                                               
                                                ▓▓▓▓    ░░  ░░        ▓  ▓▓  ░░  ▓▓                                                                 
                                                      ▓▓▓▓░░░░░░░░░░░░ ▓▓░░  ░░  ▓▓                                                                 
                                                            ▓▓    ░░░░░  ░░  ▓▓                                                                     