####################################################################################################################################################
#        ________[_]________                                                                                ^                                      #
#       /\ ▲      ______    \      ^^^^                                ▲        +                                        ▲           ▲         ▲   #
#      //_\       \    /\    \                ▲                                /_\            ▲                        &&& &&  & &&                #
#     //___\       \__/  \    \                                      ,%%%______|O|                                  && &\/&\|& ()|/ @, &&          #
#    //_____\       \ |[]|     \                                     %%%/_________\                      ^         &\/(/&/&||/& /_/)_&/_&       ^  #
#   //_______\       \|__|      \    ^              ^                `%%| /\[][][]|%                            &() &\/&|()|/&\/ '%" & ()          #
#  /XXXXXXXXXX\                  \                                  ___||_||______|%&,__                       &_\_&&_\ |& |&&/&__%_/_& &&         #
# /_I_II  I__I_\__________________\             ▲               ^           ◄──                              &&   && & &| &| /& & % ()& /&&        #
#   I_I| ▲I__I_____[]_|_[]_____I                                                                         ▲    ()&_---()&\&\|&&-&&--%---()~      ▲  #
#   I_II  I__I_____[]_|_[]_____I           ^                              & &&  & &&                              &&     \|||                      #
#   I II__I  I     XXXXXXX     I                         ^^          _/&&/&\|& ()|/ @, &&^                                |||                      #
#   ~~"   "~~~~~~~~~~~~~~~~~~~~~                        @@          &\/(/&/&||/& /_/)_&/_&                                |||                      #
#                 Home                 ▲               @         &() &\/&|()|/&\/ '%" & ()         ▲          ^           |||                 ^    #
#                                          ^            @@      &_\_&&_\ |& |&&/&__%_/_& &&                          , -=-~  .-^- _                #
#   ▲                                    ^      ▲         @   &&   && & &| &| /& & % ()& /&&                       ▲        ^                      #
#                          x                            @@     ()&_---()&\&\|&&-&&--%---()~     ^                                                  #
#       oxoxoo    ooxoo   o                            @@          &&     \|||                                                                     #
#      ooxoxo oo  oxoxooo     ^                    ____||____              |||                ▲ ▲                   ▲              ▲          ▲    #
#     oooo xxoxoo ooo ooo                        ^///////////\             |||          ^                     ▲            ▲                       #
#     oxo o oxoxo  xoxxox                        ///////////  \            |||                                                                     #
#      oxo xooxoooo o ooo                       <|    _    |  |     -=-~  .-^- _     ^                                                             #
#        ooo\oo\  /o/o           ▲              <|[] | | []|[]|│#                             ▲                                                    #
#            \  \/ /                            <|   | |   |  |└─                                                                      ┌──┬─┬──┬──=#
#             |   /                                    ◄──  ▲                                              ^    ▲                      │@@├─┤@@│@  #
#     ▲       |  |             ^   ^^              ^^^^                                                                              ┌─┴┬┬┘@│ ~└┐  #
#             | D|                            ▲            ▲              ▲                 ^       ▲                               ┌┤@@├┘@@│===│  #
#   ^^        |  |  ▲                                                                   ▲            ^                              │┼┬─┘@@┌┴──┬┤  #
#             |  |                   ^            ^              ^              ^                         ⠀⠀⠀⠀⠀⠀                  ┌─┴─┘@@┌┬┘ ~ └┤  #
#   ▲  ______/____\____                    ▲            ▲              ▲                  &&& &&  & &&                            │@@@@ ┌┼│ ~  ~│  #
#               ⠀ ⠀    ^                                                               && &\/&\|& ()|/ @, &&                ──► ──┘@~   │┼┼─┐===│  #
#      ^          ⠀                 &&& &&  & &&                                      &\/(/&/&||/& /_/)_&/_&                   │      ~─┴───┴┬──┘  #
#           ^     ⠀ ▲            && &\/&\|& ()|/ @, &&           ▲                 &() &\/&|()|/&\/ '%" & ()                   │  ~~┌──@  ~  │@    #
#                               &\/(/&/&||/& /_/)_&/_&   ^              ^         &_\_&&_\ |& |&&/&__%_/_& &&              ┌─┬┬┘ ~ ─┤@@ ~   ~│@    #
#                            &() &\/&|()|/&\/ '%" & ()     ▲              ▲     &&   && & &| &| /& & % ()& /&&             │ ├┘@@─┐ ├┐======┌┴─   ─#
#      ^                    &_\_&&_\ |& |&&/&__%_/_& &&                          ()&_---()&\&\|&&-&&--%---()~            │ ├─┘@@  └─┴┼───┬──┘@     #
#                   ^     &&   && & &| &| /& & % ()& /&&       ^                     &&     \|||                      ┌──┼─┘@@@ ~~ ~ └───┤@@@      #
#                 ▲        ()&_---()&\&\|&&-&&--%---()~                                      |||                      │┼─┘@@@ ~   =======├──  === │#
#       ▲         ⠀            &&     \|||                            ^                      |||                    ┌─┼│@@========┌──┬───┘@ ==┌───┘#
#                 ⠀                    |||                                 ▲     ^           |||                    │┼┼┴──────┬┬──┴──┤@@@  ┌──┘@@  #
#                 ⠀                    |||                                              , -=-~  .-^- _             ┌┼┼│@      └┤   ~ └──┐=┌┘@@     #
#                 ⠀      ^ ^           |||                     ▲                      ▲        ^                  ┌┴┼┼┘@   ~   └─┐~ ~   └─┤  ~ ~   #
#     ^           ⠀               , -=-~  .-^- _                      ▲                                          ┌┘@├┘@  ~       └┐   ~   └┐    ~  #
#                 ⠀             ▲        ^                                        ^ ^                           ┌┘@┌┘@ ~~     ~   │~     ~ └─┐~~   #
#                 ⠀                                                                                             │@ │@=============└─~========│=====#
####################################################################################################################################################